NO ./test_decals/grass.xpm
SO test_decals/enemie.xpm
WE test_decals/collectible.xpm
EA test_decals/exit.xpm
F 220,100,0
C 255,30,0
11111111
10000001
11100001
1000N001
10000001
10000001
11111111