NO ./test_decals/grass.xpm
SO test_decals/enemie.xpm
WE test_decals/collectible.xpm
EA test_decals/exit.xpm
F 220,100,0
C 255,30,0
1111111111111111111111111
1000000000000000000000001
1000000000000000000000001
10000000000E0000000000001
1000000001000000000000001
1000000000000000000000001
1111111111111111111111111